20,35.
00000000000000000000000000000000000
00000000000000000000000000000000000
00000000000000000000000000000000000
00000000000000000000000000000000000
00000000000000000000000000000000000
BBBBBBBBBB0000000000000000000000000
00000000000000000000000000000000000
BBBBBBBBBB0000000000000000000000000
00000000000000000000000000000000000
BBBBBBBBBB0000000000000000000000000
00000000000000000000000000000000000
000000000B0B0B000000000000000000000
00000B00000000000000000000000000000
000000000B0000000000000000000000000
0000000000B000000000000000000000000
00000B00000000B00000000000000000000
000P000000000B000000000000000000000
00000000000000000000000000000000000
00000E00000000000000000000000000000
0BBBBBBBBBBBBBBBBBBB000000000000000