30,30.
000000000000000000000000000000
000000000000000000000000000000
000000000000000000000000000000
000000000000000000000000000000
BBBBBBBB0000000000000000000000
BBBBBBBBBB00000000000000000000
BBBBBBBBBB00000000000000000000
BBBBBBBBBB00000000000000000000
BBBBBBBBBB00000000000000000000
BBBBBBBBBB00000000000000000000
000000000000000000000000000000
0000BB0B0B0B0B0000000000000000
00000B000000000000000000000000
000000000B00000000000000000000
0000000000B0000000000000000000
00000B00000000B000000000000000
0000000000000B0000000000000000
00000P000000000000000000000000
000000000000000000E00000000000
0000BBBBBBBBBBBBBBBB0000000000
0000BBBBBBBBBBBBBBBB0000000000
0000BBBBBBBBBBBBBBBB0000000000
0000BBBBBBBBBBBBBBBB0000000000
0000BBBBBBBBBBBBBBBB0000000000
0000BBBBBBBBBBBBBBBB0000000000
0000BBBBBBBBBBBBBBBB0000000000
0000BBBBBBBBBBBBBBBB0000000000
0000BBBBBBBBBBBBBBBB0000000000
0000BBBBBBBBBBBBBBBB0000000000