20,80.
BBBBBBBBBBBB000BBBBBBBBBBBBBBBBBBBBBBBBBBBBBBBBBBBBBBBBBBBBBBBBBBBB000BBBBBBBBBB
0000000000000000000000000000000000000000000000000000000000000000000000000000000B
0000000000000000000000000000000000000000000000000000000000000000000000000000000B
0000000000000000000000000000000000000000000000000000000000000000000000000000000B
0000000000000000000000000000000000000000000000000000000000000000000000000000000B
BBBBBBBBBB0000000000000000000000000BBBBBBBBBB0000000000000000000000000000000000B
0000000000000000000000000000000000000000000000000000000000000000000000000000000B
BBBBBBBBBB0000000000000000000000000BBBBBBBBBB0000000000000000000000000000000000B
0000000000000000000000000000000000000000000000000000000000000000000000000000000B
BBBBBBBBBB0000000000000000000000000BBBBBBBBBB0000000000000000000000000000000000B
0000000000000000000000000000000000000000000000000000000000000000000000000000000B
000000000B0B0B000000000000000000000000000000B0B0B000000000000000000000000000000B
00000B0000000000000000000000000000000000B00000000000000000000000000000000000000B
000000000B0000000000000000000000000000000000B0000000000000000000000000000000000B
0000000000B0000000000000000000000000000000000B000000000000000000000000000000000B
00000B00000000B0000000000000000000000000B00000000B00000000000000000000000000000B
000P000000000B0000000000000000000000000000000000B000000000000000000000000000000B
0000000000000000000000000000000000000000000000000000000000000000000000000000000B
00000E0000000000000000000000000000000000000000000000000000000000000000000000000B
0BBBBBBBBBBBBBBBBBBB0000000000000000BBBBBBBBBBBBBBBBBBB000000000000000BBBBBBBBBB