30,30.
000000000000000000000000000000
000000000000000000000000000000
000000000000000000000000000000
000000000000000000000000000000
BBBBBBBB0000000000000000000000
BBBBBBBBBB00000000000000000000
BBBBBBBBBB00000000000000000000
BBBBBBBBBB00000000000000000000
BBBBBBBBBB00000000000000000000
BBBBBBBBBB00000000000000000000
000000000000000000000000000000
0000BB0B0B0B0B0000000000000000
00000B000000000000000000000000
000000000B00000000000000000000
0000000000B0000000000000000000
00000B00000000B000000000000000
000P000000000B0000000000000000
000000000000000000000000000000
00000E000000000000000000000000
BBBBBBBBBBBBBBBBBBBB0000000000
BBBBBBBBBBBBBBBBBBBB0000000000
BBBBBBBBBBBBBBBBBBBB0000000000
BBBBBBBBBBBBBBBBBBBB0000000000
BBBBBBBBBBBBBBBBBBBB0000000000
BBBBBBBBBBBBBBBBBBBB0000000000
BBBBBBBBBBBBBBBBBBBB0000000000
BBBBBBBBBBBBBBBBBBBB0000000000
BBBBBBBBBBBBBBBBBBBB0000000000
BBBBBBBBBBBBBBBBBBBB0000000000