20,70.
0000000000000000000000000000000000000000000000000000000000000000000000
0000000000000000000000000000000000000000000000000000000000000000000000
0000000000000000000000000000000000000000000000000000000000000000000000
0000000000000000000000000000000000000000000000000000000000000000000000
0000000000000000000000000000000000000000000000000000000000000000000000
BBBBBBBBBB0000000000000000000000000BBBBBBBBBB0000000000000000000000000
0000000000000000000000000000000000000000000000000000000000000000000000
BBBBBBBBBB0000000000000000000000000BBBBBBBBBB0000000000000000000000000
0000000000000000000000000000000000000000000000000000000000000000000000
BBBBBBBBBB0000000000000000000000000BBBBBBBBBB0000000000000000000000000
0000000000000000000000000000000000000000000000000000000000000000000000
000000000B0B0B000000000000000000000000000000B0B0B000000000000000000000
00000B0000000000000000000000000000000000B00000000000000000000000000000
000000000B0000000000000000000000000000000000B0000000000000000000000000
0000000000B0000000000000000000000000000000000B000000000000000000000000
00000B00000000B0000000000000000000000000B00000000B00000000000000000000
000P000000000B0000000000000000000000000000000000B000000000000000000000
0000000000000000000000000000000000000000000000000000000000000000000000
00000E0000000000000000000000000000000000000000000000000000000000000000
0BBBBBBBBBBBBBBBBBBB0000000000000000BBBBBBBBBBBBBBBBBBB000000000000000